8 10
.f........
...f..f...
..........
.......a..
s.........
.......f..
..a.......
........h.
